2601 - Teikoku Kidoubutai no Koubou | 2601 - Teikoku Kidoubutai no Koubou.hdi
31 - Iwayuru Hitotsu no Chou Lovely na Bouken Katsugeki | 31 - Iwayuru Hitotsu no Chou Lovely na Bouken Katsugeki.hdi
3ta-kun (Santa-kun) | 3ta-kun (Santa-kun).hdi
3tsu no Negai | 3tsu no Negai.hdi
3x3 Eyes - Sanjiyan Henjou | 3x3 Eyes - Sanjiyan Henjou.hdi
46 Okunen Monogatari - The Shinkaron | 46 Okunen Monogatari - The Shinkaron.hdi
48 Night Story | 48 Night Story.hdi
5-Jikanme no Venus | 5-Jikanme no Venus.hdi
88 Kantai Monogatari | 88 Kantai Monogatari.hdi
98 Stadium | 98 Stadium (HD Boot disk).hdm | 98 Stadium.hdi
98 Stadium 2 | 98 Stadium 2 (HD Boot disk).hdm | 98 Stadium 2.hdi
A Ressha de Ikou III HD - Hard Disk Only | A Ressha de Ikou III HD - Hard Disk Only.hdi
A Ressha de Ikou IV | A Ressha de Ikou IV.hdi
A Ressha de Ikou IV Map Construction + Power Up Kit | A Ressha de Ikou IV Map Construction + Power Up Kit.hdi
Ace of Spades | Ace of Spades.hdi
AD&D Eye of the Beholder II - The Legend of Darkmoon | AD&D Eye of the Beholder II - The Legend of Darkmoon.hdi
AD&D Eye of The Beholder III - Assault on Myth Drannor | AD&D Eye of The Beholder III - Assault on Myth Drannor.hdi
Advanced Power Dolls 2 | Advanced Power Dolls 2.hdi
Aegean no Shizuku | Aegean no Shizuku.hdi
Aggregate | Aggregate.hdi
Agumix Selects! Tokusen Graphic Shuu | Agumix Selects! Tokusen Graphic Shuu.hdi
Ah! Megami-sama! | Ah! Megami-sama!.hdi
AI Igo 3 | AI Igo 3.hdi
Ai Shimai - Futari no kajitsu | Ai Shimai - Futari no kajitsu.hdi
AI Shougi | AI Shougi.hdi
AIDS - Watashi o Aishite... Jinai Seijin | AIDS - Watashi o Aishite... Jinai Seijin.hdi
Air Management 2 - Koukuuou o Mezase | Air Management 2 - Koukuuou o Mezase (HD Boot disk).hdm | Air Management 2 - Koukuuou o Mezase.hdi
Akai Suishou no Hitomi [HD] [updated] | Akai Suishou no Hitomi [updated].hdi
Akatsuki no Bizantira | Akatsuki no Bizantira.hdi
Akiko Premium Version | Akiko Premium Version.hdi
Aktie - Kabushiki Toushi Simulation Game | Aktie - Kabushiki Toushi Simulation Game.hdi
Alaskan Malamute G.C | Alaskan Malamute G.C..hdi
alchem (Sinora's Quest 2 - Alchemist wa Kiken Dearu) | alchem (Sinora's Quest 2 - Alchemist wa Kiken Dearu).hdi
Alice no Yakata II | Alice no Yakata II.hdi
Alone in the Dark (256-color PC-9821 version) | Alone in the Dark (256-color PC-9821 version).hdi
Alpha Dain | Alpha Dain.hdi
Alvaleak Boukenki | Alvaleak Boukenki.hdi
Amaranth | Amaranth.hdi
Amaranth II | Amaranth II.hdi
Amaranth III | Amaranth III.hdi
Amaranth IV | Amaranth IV.hdi
Amaranth KH | Amaranth KH.hdi
Ambivalenz - Niritsu Haihan | Ambivalenz - Niritsu Haihan.hdi
Ami - Kaze Tachinu | Ami - Kaze Tachinu.hdi
An Soft (Vintage - Active Girls Tournament) | An Soft (Vintage - Active Girls Tournament).hdi
Angel Army | Angel Army.hdi
Angel Hearts | Angel Hearts.hdi
Angel Night | Angel Night.hdi
Animahjong V3 | Animahjong V3.hdi
Animahjong X | Animahjong X.hdi
Animahjong X Perfect File | Animahjong X Perfect File.hdi
Ankoku Sennen Oukoku - Magical Cubic | Ankoku Sennen Oukoku - Magical Cubic.hdi
Anniversary - Memories of Summer Vacation | Anniversary - Memories of Summer Vacation.hdi
Apros | Apros.hdi
Arabesque | Arabesque.hdi
Arbeit - Futari no Omoi | Arbeit - Futari no Omoi.hdi
Ardor Aeternus (Wasureenu Honoo) | Ardor Aeternus (Wasureenu Honoo).hdi
Area 88 - Etranger 1995 | Area 88 - Etranger 1995.hdi
Area 88 - Ikkakujuu no Kiseki | Area 88 - Ikkakujuu no Kiseki.hdi
Armist | Armist.hdi
Artemis | Artemis.hdi
Ash | Ash..hdi
Asica Soft (D.C.S Dai-4-kan - Imouto) | Asica Soft (D.C.S Dai-4-kan - Imouto).hdi
Aso Soft (G-Fight) | Aso Soft (G-Fight).hdi
Asoko no Koufuku | Asoko no Koufuku.hdi
Atlantia | Atlantia.hdi
Ayumi-chan Monogatari | Ayumi-chan Monogatari.hdi
Azusa 108 Jimusho | Azusa 108 Jimusho.hdi
Bacta 2 | Bacta 2.hdi
Bakuretsu Quiz - Tatakae! Mighty Luna | Bakuretsu Quiz - Tatakae! Mighty Luna.hdi
Balance of the Planet | Balance of the Planet.hdi
Band-kun | Band-kun.hdi
Bangaimaru (Maze_999) | Bangaimaru (Maze_999).hdi
Battle Queen - Saikyou Fighters Retsuden | Battle Queen - Saikyou Fighters Retsuden.hdi
Battle Skin Panic 9821 | Battle Skin Panic 9821.hdi
Battletech - Ubawareta Seihai | Battletech - Ubawareta Seihai.hdi
Bay City Elegy | Bay City Elegy.hdi
Be-Yond | Be-Yond.hdi
Beast Breeders | Beast Breeders.hdi
Beast Lord - Haou e no Michi | Beast Lord - Haou e no Michi.hdi
Beat Vice | Beat Vice.hdi
Bell's Avenue | Bell's Avenue.hdi
Bell's Avenue 2 | Bell's Avenue 2.hdi
Bell's Avenue 3 | Bell's Avenue 3.hdi
Bible Master 2 | Bible Master 2.hdi
Big Honour | Big Honour.hdi
Bind - Kinbaku Jinmon Densetsu | Bind - Kinbaku Jinmon Densetsu.hdi
Binyuu Hunter | Binyuu Hunter.hdi
Bio_100% (Owl-Zoo) | Bio_100% (Owl-Zoo).hdi
Birdy World | Birdy World.hdi
Birth Days | Birth Days.hdi
Bishoujo Audition - Idol o Sagase! | Bishoujo Audition - Idol o Sagase!.hdi
Bishoujo Hunter ZX | Bishoujo Hunter ZX.hdi
Bishoujo Tengoku | Bishoujo Tengoku.hdi
Black Bird | Black Bird.hdi
Black Rainbow | Black Rainbow.hdi
Black Rainbow II | Black Rainbow II.hdi
Black-Tonosama (Tonosama vs Satan) | Black-Tonosama (Tonosama vs Satan).hdi
Blackthorne - Jigoku no Fukushuu | Blackthorne - Jigoku no Fukushuu.hdi
Blade of Darkness (Kuro no Ken) | Blade of Darkness (Kuro no Ken).hdi
Blind Games | Blind Games.hdi
Block Out | Block Out.hdi
Block Quest V | Block Quest V.hdi
Blue - Will to Power | Blue - Will to Power (HD Boot disk).hdm | Blue - Will to Power (HD User disk).hdm | Blue - Will to Power.hdi
Blue Garnet | Blue Garnet.hdi
Blue Ruins | Blue Ruins.hdi
BMP (Teki wa Ningen) | BMP (Teki wa Ningen).hdi
Bolze (Natsuyasumi ga Machidooshii - Holidays in the Sun) | Bolze (Natsuyasumi ga Machidooshii - Holidays in the Sun).hdi
Bomber Quest | Bomber Quest.hdi
Bonnou Yobikou 2 | Bonnou Yobikou 2.hdi
Bonnou Yobikou 3 | Bonnou Yobikou 3.hdi
Brah - Choushinden | Brah - Choushinden.hdi
Brandish 2 - The Planet Buster | Brandish 2 - The Planet Buster.hdi
Briganty | Briganty.hdi
BTB Software (Sakura) | BTB Software (Sakura).hdi
Bunkasai | Bunkasai.hdi
Bunny Hunter Zero | Bunny Hunter Zero.hdi
Bunretsu Shugoshin Twinkle Star | Bunretsu Shugoshin Twinkle Star.hdi
Burning Dragon | Burning Dragon.hdi
Burning Dragon Plus | Burning Dragon Plus.hdi
C'est la vie | C'est la vie.hdi
Cal Gaiden - Tiny Steps Behind the Cal | Cal Gaiden - Tiny Steps Behind the Cal.hdi
Cal III Kanketsuhen [HD] [req Disk A] | Cal III Kanketsuhen.hdi
Call of Cthulhu - Shadow of the Comet | Call of Cthulhu - Shadow of the Comet.hdi
Camisole | Camisole.hdi
Can Can Bunny Extra | Can Can Bunny Extra.hdi
Can Can Bunny Limited 5 1-2 | Can Can Bunny Limited 5 1-2.hdi
Can Can Bunny Premiere | Can Can Bunny Premiere.hdi
Canaan - Yakusoku no Chi | Canaan - Yakusoku no Chi.hdi
Caramel Quest - Meitenkyuu no Megamizou | Caramel Quest - Meitenkyuu no Megamizou {GDC 5MHz}.hdi
Castles II - Bretagne Touitsu Senki | Castles II - Bretagne Touitsu Senki.hdi
Cat's Part 1 | Cat's Part 1.hdi
Chakura - Challenger Club | Chakura - Challenger Club.hdi
Charade | Charade.hdi
Charm 2 - Nijiiro no Kaze | Charm 2 - Nijiiro no Kaze.hdi
Check Six 2 Special | Check Six 2 Special.hdi
Cherry Jam | Cherry Jam.hdi
Cherry Moderate | Cherry Moderate.hdi
Chicks' Tale | Chicks' Tale.hdi
Chiemi | Chiemi.hdi
Chikudenya Toubee - Hiroku Chigyaku no Yakata | Chikudenya Toubee - Hiroku Chigyaku no Yakata.hdi
Chikyuu Bouei Shoujo Iko-chan - UFO Daisakusen | Chikyuu Bouei Shoujo Iko-chan - UFO Daisakusen.hdi
Chime's Quest | Chime's Quest.hdi
Chitty Chitty Train | Chitty Chitty Train.hdi
Chou-Baku | Chou-Baku.hdi
Choushinri Samadhi | Choushinri Samadhi.hdi
Chrome Paradise - Ginhakushoku no Rakuen (with Special Disk) | Chrome Paradise - Ginhakushoku no Rakuen (with Special Disk).hdi
Chuushaki - Hirasawa Nurse School | Chuushaki - Hirasawa Nurse School.hdi
Circle Mate | Circle Mate.hdi
Classic Road 2 | Classic Road 2.hdi
Classic Road 3 | Classic Road 3.hdi
Classic Road 4 | Classic Road 4.hdi
Clone Doll - Kagai Jugyou | Clone Doll - Kagai Jugyou.hdi
CO2-Pro (Last Breakers - Gray Nova Aggression) | CO2-Pro (Last Breakers - Gray Nova Aggression).hdi
Cocktail Soft Zoukangou 2 | Cocktail Soft Zoukangou 2.hdi
Coin | Coin.hdi
Collector D | Collector D.hdi
Collector D Bangaihen | Collector D Bangaihen.hdi
Coming Heart | Coming Heart.hdi
Company | Company (HD Boot disk).hdm | Company.hdi
Concert | Concert.hdi
Crescent | Crescent.hdi
Cross Changer | Cross Changer.hdi
Crusher Joe - Kanraku Wakusei no Inbou | Crusher Joe - Kanraku Wakusei no Inbou.hdi
CRW Metal Jacket | CRW Metal Jacket.hdi
Crystal Soft (Wanderers) | Crystal Soft (Wanderers).hdi
Curse | Curse.hdi
Custom Mate | Custom Mate.hdi
Custom Mate 2 | Custom Mate 2.hdi
Custom Mate 3 | Custom Mate 3.hdi
Cutie Cop - Nusumareta File no Nazo | Cutie Cop - Nusumareta File no Nazo.hdi
Cyber Illusion | Cyber Illusion.hdi
Cybernetic Hi-School III - Top o Nerae! | Cybernetic Hi-School III - Top o Nerae!.hdi
Cybernetic Hi-School IV - Ape Hunter J | Cybernetic Hi-School IV - Ape Hunter J.hdi
Cybernetic Hi-School Version 2.0 | Cybernetic Hi-School Version 2.0.hdi
D'ark | D'ark.hdi
D'ark Gaiden | D'ark Gaiden.hdi
D.O. Doki Doki Disk Vol. 8 | D.O. Doki Doki Disk Vol. 8.hdi
D.O. Doki Doki Disk Vol. 9 | D.O. Doki Doki Disk Vol. 9.hdi
D.O. Kaizokuban | D.O. Kaizokuban (Disk A-B) (DOR).hdi | D.O. Kaizokuban (Disk C) (Hoshi no Suna Monogatari).hdi
Dai-1-kai ASCII Entertainment Software Contest (Wicca!!) | Dai-1-kai ASCII Entertainment Software Contest (Wicca!!).hdi
Daigekichin - Nichibei Kaitei no Taiketsu | Daigekichin - Nichibei Kaitei no Taiketsu.hdi
Daijuutai | Daijuutai.hdi
Daikaisen Solomon 1942-1943 | Daikaisen Solomon 1942-1943.hdi
Daikoukai Jidai II | Daikoukai Jidai II (HD Boot disk).hdm | Daikoukai Jidai II.hdi
Daimanji, Gakushu-Juku (Kyun Kyun Fruits - Napple City Volume 1) | Daimanji, Gakushu-Juku (Kyun Kyun Fruits - Napple City Volume 1).hdi
Daisenryaku IV (with Tsuika Data, Powerup Kit, Powerup Book) | Daisenryaku IV (with Tsuika Data, Powerup Kit, Powerup Book) (HD Boot disk).hdm | Daisenryaku IV (with Tsuika Data, Powerup Kit, Powerup Book).hdi
Dalk | Dalk (v1.08) (uncensored).hdi
Dangerous Toys | Dangerous Toys.hdi
Dare mo Shiranai... Ushinawareta Kioku no Tobira | Dare mo Shiranai... Ushinawareta Kioku no Tobira.hdi
Dareka... Special | Dareka... Special.hdi
Darwin's Dilemma | Darwin's Dilemma.hdi
Das Schwert des Paracelsus (Paracelsus no Maken) | Das Schwert des Paracelsus (Paracelsus no Maken).hdi
De-Ja | De-Ja.hdi
De-Ja II | De-Ja II.hdi
Dead Force | Dead Force.hdi
Dead of the Brain 2 | Dead of the Brain 2.hdi
Deep | Deep.hdi
Deja Vu - Hikisakareta Kioku | Deja Vu - Hikisakareta Kioku.hdi
Delicious Lunchpack | Delicious Lunchpack.hdi
Delphi no Shintaku | Delphi no Shintaku (HD Boot disk).hdm | Delphi no Shintaku.hdi
Demon City | Demon City.hdi
Dengeki Division | Dengeki Division.hdi
Dengeki Nurse | Dengeki Nurse.hdi
Dengeki Nurse 2 - More Sexy | Dengeki Nurse 2 - More Sexy.hdi
Dennou Garou | Dennou Garou.hdi
Dennou Kintoun (Ushinawareta Miyako) | Dennou Kintoun (Ushinawareta Miyako).hdi
Dennou Sentai Ravian Three | Dennou Sentai Ravian Three.hdi
Dennou Tenshi - Digital Ange | Dennou Tenshi - Digital Ange.hdi
Derby Stallion Expert Kit | Derby Stallion Expert Kit.hdi
Desert Dragoon | Desert Dragoon.hdi
Diadrum | Diadrum (HD Boot disk).hdm | Diadrum.hdi
Different Realm - Kuon no Kenja | Different Realm - Kuon no Kenja.hdi
Diver's | Diver's.hdi
Doki Doki Pretty League Dai-1-wa - Pink Angels Kiki Ippatsu no Maki | Doki Doki Pretty League Dai-1-wa - Pink Angels Kiki Ippatsu no Maki.hdi
Doki Doki Pretty League Dai-2-wa - Mou Hitotsu no Rival | Doki Doki Pretty League Dai-2-wa - Mou Hitotsu no Rival.hdi
Doki Doki Pretty League Dai-3-wa - Minami no Umi no Kai no Maki | Doki Doki Pretty League Dai-3-wa - Minami no Umi no Kai no Maki.hdi
Doki Doki Pretty League Dai-4-wa - Nanase no Himitsu no Maki | Doki Doki Pretty League Dai-4-wa - Nanase no Himitsu no Maki.hdi
Doki Doki Pretty League Dai-5-wa - Saraba Pink Angels-tachi | Doki Doki Pretty League Dai-5-wa - Saraba Pink Angels-tachi.hdi
Dokuritsu Sensou - Liberty or Death | Dokuritsu Sensou - Liberty or Death (HD Boot disk).hdm | Dokuritsu Sensou - Liberty or Death.hdi
Doop | Doop.hdi
Doppyun Donpisha | Doppyun Donpisha.hdi
DOR Part 1 | DOR Part 1.hdi
DOR Part 2 | DOR Part 2.hdi
DOR Part 3 | DOR Part 3.hdi
DOR Special Edition Sakigake | DOR Special Edition Sakigake.hdi
Dora Dora Emotion - Seihaiden | Dora Dora Emotion - Seihaiden.hdi
Doukyuusei | Doukyuusei.hdi
Doukyuusei 2 (with Special Disk) | Doukyuusei 2 (with Special Disk).hdi
Dr. Brain - Puzzle no Shiro | Dr. Brain - Puzzle no Shiro.hdi
Dr. Stop! | Dr. Stop!.hdi
Dracula Hakushaku | Dracula Hakushaku.hdi
Dragon Knight 4 | Dragon Knight 4.hdi
Dragon Knight II | Dragon Knight II.hdi
Dragon Knight III | Dragon Knight III.hdi
Dragon Master Silk | Dragon Master Silk.hdi
Dragon Master Silk II | Dragon Master Silk II.hdi
Dragon Slayer - The Legend of Heroes (Eiyuu Densetsu) II | Dragon Slayer - The Legend of Heroes (Eiyuu Densetsu) II.hdi
Dragon Souseiki | Dragon Souseiki.hdi
Dragon Wars | Dragon Wars.hdi
Drakkhen | Drakkhen.hdi
Dream Theater | Dream Theater.hdi
DR^2 Night Janki | DR^2 Night Janki.hdi
Dual Soul | Dual Soul.hdi
Duel Succession | Duel Succession.hdi
Dungeon Conquest | Dungeon Conquest.hdi
Dungeon Hack | Dungeon Hack.hdi
Dungeon Master II - Skullkeep | Dungeon Master II - Skullkeep.hdi
Early Kingdom [HD] [req Character disk] | Early Kingdom (HD Boot disk).hdm | Early Kingdom.hdi
Eden no Kaori | Eden no Kaori.hdi
Edge | Edge.hdi
Eikan wa Kimi ni 3 | Eikan wa Kimi ni 3.hdi
Eisei Meijin II | Eisei Meijin II.hdi
Eisei Meijin III | Eisei Meijin III.hdi
Ekudorado - Kagami no Naka no Oukoku | Ekudorado - Kagami no Naka no Oukoku.hdi
El Dominion | El Dominion.hdi
Electric Device Marian (Kikaijikake no Marian) | Electric Device Marian (Kikaijikake no Marian).hdi
Elemental Ou | Elemental Ou.hdi
Elle | Elle.hdi
Elvira - Mistress of the Dark | Elvira - Mistress of the Dark.hdi
Engage Errands | Engage Errands.hdi
Engage Errands II | Engage Errands II.hdi
Epic | Epic (HD Boot disk).hdm | Epic.hdi
Epson MS-DOS 5.00 (Rel. 2) | Epson MS-DOS 5.00 (Rel. 2).hdi
Erotic Baka Novel - Denwa no Bell ga | Erotic Baka Novel - Denwa no Bell ga....hdi
Erotic Baka Novel Series 2 - Itsuka Dokoka de | Erotic Baka Novel Series 2 - Itsuka Dokoka de..hdi
Es no Houteishiki | Es no Houteishiki.hdi
Escalation '95 | Escalation '95.hdi
Escape! | Escape!.hdi
Estate | Estate.hdi
Estoria | Estoria.hdi
Etemible - Tenjou Mukyuu | Etemible - Tenjou Mukyuu.hdi
Eve Burst Error | Eve Burst Error.hdi
Ex-Lander - Aoki Monshou no Kishidan | Ex-Lander - Aoki Monshou no Kishidan.hdi
Exceed Jack | Exceed Jack.hdi
F-117A Nighthawk Stealth Fighter 2.0 | F-117A Nighthawk Stealth Fighter 2.0.hdi
F-14 Fleet Defender | F-14 Fleet Defender.hdi
F29 Retaliator | F29 Retaliator.hdi
Faladia | Faladia (HD User disk).hdm | Faladia.hdi
Falcom Character CG | Falcom Character CG.hdi
Farce - Yuuwaku Hakusho | Farce - Yuuwaku Hakusho.hdi
Farland Story - Daichi no Kizuna | Farland Story - Daichi no Kizuna.hdi
Farland Story - Hakugin no Tsubasa | Farland Story - Hakugin no Tsubasa.hdi
Farland Story - Juuou no Akashi | Farland Story - Juuou no Akashi.hdi
Farland Story - Kamigami no Isan | Farland Story - Kamigami no Isan.hdi
Farland Story - Tenshi no Namida | Farland Story - Tenshi no Namida.hdi
Farland Story - Tooi Kuni no Monogatari | Farland Story - Tooi Kuni no Monogatari.hdi
Farland Story Denki - Arc Ou no Ensei | Farland Story Denki - Arc Ou no Ensei.hdi
Fenrir (Agalta II) | Fenrir (Agalta II).hdi
Fermion | Fermion.hdi
Feti (Fetish) | Feti (Fetish).hdi
Fifth Element II - Hikari to Yami no Ouji | Fifth Element II - Hikari to Yami no Ouji.hdi
Figure | Figure.hdi
FILE - Kokubousoushou Jouhoubu Jouhourouei Taisakubu Josei Jinmonin | FILE - Kokubousoushou Jouhoubu Jouhourouei Taisakubu Josei Jinmonin.hdi
File 0 - Ghost Killer Kamimura Rei | File 0 - Ghost Killer Kamimura Rei.hdi
Filsnown - Hikari to Toki | Filsnown - Hikari to Toki.hdi
Final Breaker | Final Breaker.hdi
Finish Hold | Finish Hold.hdi
First Queen III | First Queen III.hdi
First Queen IV - Barcia Senki | First Queen IV - Barcia Senki.hdi
Flappy Plus | Flappy Plus.hdi
Flashback | Flashback.hdi
Flix Mix | Flix Mix {GDC 5MHz}.hdi
Floppy Bunko 11 - Listener's Club 0990 Vol. 2 ('92 Aki-gou) | Floppy Bunko 11 - Listener's Club 0990 Vol. 2 ('92 Aki-gou).hdi
FMP (FMP Music Disk Vol. 4) | FMP (FMP Music Disk Vol. 4).hdi
Foresight Dolly | Foresight Dolly.hdi
Four Flush | Four Flush.hdi
Foxy 2 | Foxy 2.hdi
Free Soft Library Game Collection 30 | Free Soft Library Game Collection 30.hdi
Free Soft Library Game Collection 30 Again | Free Soft Library Game Collection 30 Again.hdi
Free Soft Library Game Collection Bangaihen - Chotto dake yo | Free Soft Library Game Collection Bangaihen - Chotto dake yo.hdi
Free Will - Knight of Argent | Free Will - Knight of Argent (HD Boot disk).hdm | Free Will - Knight of Argent (HD User disk).hdm | Free Will - Knight of Argent.hdi
FreeDOS(98) Kernel compatibility 6.20 | FreeDOS(98) Kernel compatibility 6.20.hdi
Frontier | Frontier.hdi
Frontier Universe | Frontier Universe (HD Boot disk).hdm | Frontier Universe.hdi
Fuga Selection 1 | Fuga Selection 1.hdi
Fushigi no Umi no Nadia | Fushigi no Umi no Nadia.hdi
Future Wars | Future Wars.hdi
Fuzoroi no Lemon | Fuzoroi no Lemon.hdi
G.R. - Gravity Response | G.R. - Gravity Response.hdi
Gaias Lord | Gaias Lord.hdi
Gakuen Bakuretsu Tenkousei! | Gakuen Bakuretsu Tenkousei!.hdi
Gakuen Bomber | Gakuen Bomber.hdi
Gakuen Monogatari '93 - The Instinct | Gakuen Monogatari '93 - The Instinct.hdi
Gakuen Monogatari - Ikenai Houkago | Gakuen Monogatari - Ikenai Houkago.hdi
Gakuen Senki - Kyoufu no Puppet Keikaku | Gakuen Senki - Kyoufu no Puppet Keikaku.hdi
Gakuen Senshi Sailor Fighter | Gakuen Senshi Sailor Fighter.hdi
Gakuen Sodom | Gakuen Sodom.hdi
Gakuen Taimaden Reiko | Gakuen Taimaden Reiko.hdi
Gakuen Triangle | Gakuen Triangle.hdi
Gamble Racer | Gamble Racer (HD Boot disk).hdm | Gamble Racer.hdi
Gambler - Queen's Cup | Gambler - Queen's Cup.hdi
Gaogao! 1st - Radical Sequence | Gaogao! 1st - Radical Sequence.hdi
Gaogao! 2nd - Pandora Wood | Gaogao! 2nd - Pandora Wood.hdi
Gaogao! 3rd - Wild Force | Gaogao! 3rd - Wild Force.hdi
Gaogao! Optional Disk | Gaogao! Optional Disk.hdi
Garyouden - Sangoku Seiha no Kei | Garyouden - Sangoku Seiha no Kei.hdi
GE-TEN II - Taikai Nobunaga Den | GE-TEN II - Taikai Nobunaga Den.hdi
Gedou Kyoushi - Ryoujoku Shuukan | Gedou Kyoushi - Ryoujoku Shuukan.hdi
Gekitou! Oushuu Kaisenshi | Gekitou! Oushuu Kaisenshi.hdi
Gekitou! Solomon Kaisenshi | Gekitou! Solomon Kaisenshi.hdi
Gendai Daisenryaku EX | Gendai Daisenryaku EX.hdi
Genpei Kassen | Genpei Kassen (HD Boot disk).hdm | Genpei Kassen.hdi
Gensei Kitan - Disc Saga III | Gensei Kitan - Disc Saga III.hdi
Gentoku's.com (Coin 2) | Gentoku's.com (Coin 2).hdi
Geo Slave - Aidotachi no Shouzou | Geo Slave - Aidotachi no Shouzou.hdi
Get! (v1.3) | Get! (v1.3).hdi
GGG Soft (Galt-Rio Maximum Position) | GGG Soft (Galt-Rio Maximum Position).hdi
Giga Motion | Giga Motion.hdi
Ginga Eiyuu Densetsu III | Ginga Eiyuu Densetsu III.hdi
Ginga Eiyuu Densetsu III SP | Ginga Eiyuu Densetsu III SP.hdi
Ginga Eiyuu Densetsu IV (with update) | Ginga Eiyuu Densetsu IV (with update).hdi
Ginga Eiyuu Densetsu IV EX | Ginga Eiyuu Densetsu IV EX.hdi
Ginga Tetsudou no Tabi | Ginga Tetsudou no Tabi.hdi
Ginga Yuukyou Densetsu Tobacker | Ginga Yuukyou Densetsu Tobacker.hdi
Giri Giri Telephone Call | Giri Giri Telephone Call.hdi
Girl | Girl.hdi
Girl 2 | Girl 2.hdi
Glass no Destiny | Glass no Destiny.hdi
Gloria - Kindan no Ketsuzoku | Gloria - Kindan no Ketsuzoku.hdi
Godzilla | Godzilla.hdi
Goice | Goice.hdi
Gokanshi | Gokanshi.hdi
Gokko Vol. 1 - Doctor | Gokko Vol. 1 - Doctor.hdi
Gokko Vol. 2 - School Gal's | Gokko Vol. 2 - School Gal's.hdi
Gokko Vol. 3 - Etcetera | Gokko Vol. 3 - Etcetera.hdi
Gokuraku Mandara | Gokuraku Mandara.hdi
Gra-Pro (Sugayers) | Gra-Pro (Sugayers).hdi
Grand Prix Circus | Grand Prix Circus.hdi
Grand Prix Circus 2 | Grand Prix Circus 2.hdi
Graystone Saga - Demon's Fountain | Graystone Saga - Demon's Fountain.hdi
Graystone Saga Gaiden - The Dark Storm of Morza | Graystone Saga Gaiden - The Dark Storm of Morza.hdi
Green Oasis | Green Oasis.hdi
Griffon (Kitty World 2) | Griffon (Kitty World 2).hdi
Grossdeutschland | Grossdeutschland.hdi
Grounseed | Grounseed.hdi
Guernica | Guernica.hdi
Gun Blaze | Gun Blaze.hdi
Gunship 2000 | Gunship 2000.hdi
H+ | H+.hdi
H-Go! Yeah! | H-Go! Yeah!.hdi
Hal (The I-O City) | Hal (The I-O City).hdi
Half-Pipe | Half-Pipe.hdi
Halfmoon ni Kawaru made | Halfmoon ni Kawaru made.hdi
Hamlet | Hamlet.hdi
Hana no Kioku Dai-2-shou | Hana no Kioku Dai-2-shou.hdi
Hana Yori Dango | Hana Yori Dango.hdi
Hana Yori Dango 2 | Hana Yori Dango 2.hdi
Hard Special Selection - Katamari | Hard Special Selection - Katamari.hdi
Hare Nochi Munasawagi! | Hare Nochi Munasawagi!.hdi
Harenchi Gakuen | Harenchi Gakuen.hdi
Harlem Blade | Harlem Blade.hdi
Harpoon | Harpoon.hdi
Harpoon - The Next Mission | Harpoon - The Next Mission.hdi
Hatchake Ayayo-san 2 | Hatchake Ayayo-san 2.hdi
Hatchake Ayayo-san 4 | Hatchake Ayayo-san 4 (uncensored).hdi
Hatchake Ayayo-san 5 | Hatchake Ayayo-san 5.hdi
Hatsukoi Monogatari | Hatsukoi Monogatari.hdi
Hayate The Battle | Hayate The Battle.hdi
Heart Heat Girls (HHG) | Heart Heat Girls (HHG).hdi
HedgehoG | HedgehoG.hdi
Hercequary | Hercequary.hdi
High Reward | High Reward.hdi
High School Days | High School Days.hdi
High School War | High School War.hdi
Hiiro no Shimai | Hiiro no Shimai.hdi
Himitsu Shirei 1919 (Dai-2-wa) | Himitsu Shirei 1919 (Dai-2-wa).hdi
Hinadori no Saezuri (v1.04D) | Hinadori no Saezuri (v1.04D).hdi
Hiouden II' HD | Hiouden II' HD.hdi
Hiroki Sakata (Little Adventure - Aru to Chiisana Bouken) | Hiroki Sakata (Little Adventure - Aru to Chiisana Bouken).hdi
Hizumi | Hizumi.hdi
Hobby Land Soft (Demon's Eye) | Hobby Land Soft (Demon's Eye).hdi
Honwaka Soft (Oshioki Kirai 2 1993-05-26 version) | Honwaka Soft (Oshioki Kirai 2 1993-05-26 version).hdi
Hop Step Jump | Hop Step Jump.hdi
Horny Sweeper | Horny Sweeper.hdi
Horny Sweeper 2 | Horny Sweeper 2.hdi
Hoshi no Suna Monogatari 2 | Hoshi no Suna Monogatari 2.hdi
Hou Tei Rao Yui II | Hou Tei Rao Yui II.hdi
Houou no Gotoku - Ranse no Hasha Nobunaga | Houou no Gotoku - Ranse no Hasha Nobunaga.hdi
HR2 - How Many Robot 2 | HR2 - How Many Robot 2.hdi
HRS (Planetters) | HRS (Planetters).hdi
Hunting Roulette - Totsugeki Bakkon Street II | Hunting Roulette - Totsugeki Bakkon Street II.hdi
Hyouryuu | Hyouryuu.hdi
Hyper Mahjong Mangan Zenseki | Hyper Mahjong Mangan Zenseki.hdi
Hyper Securities - Kinmirai Bishoujo Police Nisshi | Hyper Securities - Kinmirai Bishoujo Police Nisshi.hdi
Ides User's Club Disk Magazine #004 | Ides User's Club Disk Magazine #004.hdi
Idol Project | Idol Project.hdi
Idol Project 2 | Idol Project 2.hdi
Ieyasu Senki | Ieyasu Senki.hdi
if | if.hdi
if 2 | if 2.hdi
if 3 | if 3.hdi
Igo Seiten | Igo Seiten.hdi
Ikenie - Kyouraku no Shinden | Ikenie - Kyouraku no Shinden.hdi
Iku Iku Pakkun | Iku Iku Pakkun.hdi
Image | Image.hdi
Image II | Image II.hdi
Image Room - Banana Club | Image Room - Banana Club.hdi
Immoral Study Scenario 1 - Shirakawa Reiko | Immoral Study Scenario 1 - Shirakawa Reiko.hdi
Immoral Study Scenario 2 - Iijima Yuka | Immoral Study Scenario 2 - Iijima Yuka.hdi
Immoral Study Scenario 3 - Asakura Manami | Immoral Study Scenario 3 - Asakura Manami.hdi
Injuu Gakuen - La Blue Girl | Injuu Gakuen - La Blue Girl.hdi
Injuu Genmu | Injuu Genmu.hdi
Injuu Genmu II - Brain Burst!! | Injuu Genmu II - Brain Burst!!.hdi
Injuu no Datenshi - Requiem for Fallen Angels | Injuu no Datenshi - Requiem for Fallen Angels.hdi
Inma Seifukugari | Inma Seifukugari.hdi
Ippatsu Jang! | Ippatsu Jang!.hdi
Iris-tei Serenade | Iris-tei Serenade.hdi
Irium | Irium.hdi
Isaku | Isaku.hdi
Isekai Denshou Joshua | Isekai Denshou Joshua.hdi
Isis (Time Travel from 25XX) | Isis (Time Travel from 25XX).hdi
J. League Professional Soccer 1995 | J. League Professional Soccer 1995 (HD Boot disk).hdm | J. League Professional Soccer 1995.hdi
Jack - Haitoku no Megami | Jack - Haitoku no Megami.hdi
Jan Borg Suzume | Jan Borg Suzume.hdi
Jan Jaka Jan | Jan Jaka Jan.hdi
Jangou 4 | Jangou 4.hdi
Janou Touryuumon II | Janou Touryuumon II.hdi
Janpuu | Janpuu (HD Boot disk).hdm | Janpuu.hdi
Janpuu 2 | Janpuu 2 (HD Boot disk).hdm | Janpuu 2.hdi
Japan Bashing | Japan Bashing.hdi
Japanese Cult Quiz Zipang | Japanese Cult Quiz Zipang.hdi
Jealousy | Jealousy.hdi
Jedai | Jedai.hdi
Jikuu Sasatsukan Hayate - Inspector | Jikuu Sasatsukan Hayate - Inspector.hdi
Jinn - Eternal Hero | Jinn - Eternal Hero.hdi
Joker II | Joker II.hdi
Jonason - Kugutsu no Mai | Jonason - Kugutsu no Mai.hdi
Jorou Gumo | Jorou Gumo.hdi
Joshikou Seifuku Monogatari | Joshikou Seifuku Monogatari.hdi
Juushin Rogus | Juushin Rogus.hdi
JYB | JYB.hdi
Kagaku Ninjatai Gatchaman - Taose! Galactor | Kagaku Ninjatai Gatchaman - Taose! Galactor.hdi
Kagayake! Kirakira Senshi Risky Jewel | Kagayake! Kirakira Senshi Risky Jewel.hdi
Kaiketsu Nikki | Kaiketsu Nikki.hdi
Kairaku no Okite - Aoi Taiken | Kairaku no Okite - Aoi Taiken.hdi
Kakinoki Shougi | Kakinoki Shougi.hdi
Kakutou Musume Ryouko | Kakutou Musume Ryouko.hdi
Kakyuusei (with Special Disk) | Kakyuusei (with Special Disk).hdi
Kanako | Kanako.hdi
Kangoku Country Club | Kangoku Country Club.hdi
Kankin | Kankin.hdi
Kannou Kyoushuu - Sensual Training | Kannou Kyoushuu - Sensual Training.hdi
Kara no Naka no Kotori | Kara no Naka no Kotori.hdi
Karei naru Jinsei | Karei naru Jinsei.hdi
Karei naru Jinsei 2 | Karei naru Jinsei 2.hdi
Kassen Sekigahara | Kassen Sekigahara.hdi
Kawarazakike no Ichizoku | Kawarazakike no Ichizoku.hdi
Kekkou Kamen - Oshioki Paradise no Maki | Kekkou Kamen - Oshioki Paradise no Maki.hdi
Kekkou Kamen 2 - Oshioki Densetsu no Maki | Kekkou Kamen 2 - Oshioki Densetsu no Maki.hdi
Kerakeraboshi | Kerakeraboshi.hdi
KIDS - SAP 2nd File | KIDS - SAP 2nd File.hdi
Kinbaku no Yakata | Kinbaku no Yakata.hdi
Kindan no Ketsuzoku | Kindan no Ketsuzoku.hdi
King's Bounty - Nusumareta Chitsujo | King's Bounty - Nusumareta Chitsujo.hdi
King's Quest V | King's Quest V.hdi
Kirishima Shinryoushitsu no Gogo | Kirishima Shinryoushitsu no Gogo.hdi
Kishi Densetsu | Kishi Densetsu.hdi
Kisou Shinden Gen-Kaiser | Kisou Shinden Gen-Kaiser.hdi
Kitoujima Joshi Keimusho | Kitoujima Joshi Keimusho.hdi
Kiwame Daigougi | Kiwame Daigougi.hdi
Kizuato | Kizuato.hdi
Knights of the Sky | Knights of the Sky.hdi
Koihime - Mystic Princess | Koihime - Mystic Princess.hdi
Konpeki no Kantai | Konpeki no Kantai.hdi
Konpeki no Kantai 2 Perfect | Konpeki no Kantai 2 Perfect.hdi
Koroshi no Dress | Koroshi no Dress.hdi
Koroshi no Dress 3 | Koroshi no Dress 3.hdi
Kotetsu no Daibouken | Kotetsu no Daibouken.hdi
Kotohigaoka Monogatari | Kotohigaoka Monogatari.hdi
Koukan Nikki | Koukan Nikki.hdi
Koukan Nikki II | Koukan Nikki II.hdi
Koukou Kyoushi - St. Erika Jogakuin Hen | Koukou Kyoushi - St. Erika Jogakuin Hen.hdi
Kouryuuki | Kouryuuki (HD Boot disk).hdm | Kouryuuki.hdi
Kousoku - Yorokobi no Juice | Kousoku - Yorokobi no Juice.hdi
Kousoku Chojin | Kousoku Chojin.hdi
Kremlin Twilight | Kremlin Twilight.hdi
Kremlin Twilight - Diamonds Hen | Kremlin Twilight - Diamonds Hen.hdi
Kremlin Twilight - Espionage Hen | Kremlin Twilight - Espionage Hen.hdi
Kremlin Twilight - Grechka Hen | Kremlin Twilight - Grechka Hen.hdi
Kurayami | Kurayami.hdi
Kuro no Danshou - The Literary Fragment | Kuro no Danshou - The Literary Fragment.hdi
Kuronekokan | Kuronekokan.hdi
Kurukuru Party - Princess Quest | Kurukuru Party - Princess Quest.hdi
Kurumi-chan Ninja | Kurumi-chan Ninja.hdi
Kusuriyubi no Kyoukasho | Kusuriyubi no Kyoukasho.hdi
Kuubo Senki | Kuubo Senki.hdi
Kuugun Daisenryaku | Kuugun Daisenryaku.hdi
Kyouhaku | Kyouhaku.hdi
Kyouiku Jisshuu - Joshikousei Maniax | Kyouiku Jisshuu - Joshikousei Maniax.hdi
Kyouko no Ijiwaru!! | Kyouko no Ijiwaru!!.hdi
Kyrandia II - The Hand of Fate | Kyrandia II - The Hand of Fate.hdi
Kyuukyoku Mahjong Idol Graphic | Kyuukyoku Mahjong Idol Graphic.hdi
L-est | L-est.hdi
Lands of Lore | Lands of Lore.hdi
Laser Squad | Laser Squad.hdi
Last Guardian | Last Guardian (Disk 1).hdi
Last Guardian 2 | Last Guardian 2.hdi
Leap - Toki ni Sarawareta Shoujo | Leap - Toki ni Sarawareta Shoujo.hdi
Legam | Legam.hdi
Legend of Killcool | Legend of Killcool.hdi
Legend of Pong Lonng Fighter Sunny'na | Legend of Pong Lonng Fighter Sunny'na.hdi
Legend of Rouge (Rouge no Densetsu) | Legend of Rouge (Rouge no Densetsu) (HD Boot disk).hdm | Legend of Rouge (Rouge no Densetsu).hdi
Legend of Shalice | Legend of Shalice.hdi
Lemmings | Lemmings.hdi
Lemon Angel | Lemon Angel.hdi
Lesser Mern | Lesser Mern.hdi
Libido 7 (uncensored) | Libido 7 (uncensored).hdi
Libido 7 Impact | Libido 7 Impact.hdi
Liena Crystal - Adventure of Liena | Liena Crystal - Adventure of Liena.hdi
Life & Death | Life & Death.hdi
Like | Like.hdi
Lilith | Lilith.hdi
Lipstick Adventure 3 | Lipstick Adventure 3.hdi
Lixus | Lixus.hdi
Locus Alba | Locus Alba.hdi
Locus Alba Gaiden | Locus Alba Gaiden.hdi
LOGiN Disk & Book Series - 16-color Pata Pata Anime Tsukuuru | LOGiN Disk & Book Series - 16-color Pata Pata Anime Tsukuuru.hdi
LOGiN Disk & Book Series - 256-color Oekaki Tsukuuru | LOGiN Disk & Book Series - 256-color Oekaki Tsukuuru.hdi
LOGiN Disk & Book Series - Adventure Tsukuuru II | LOGiN Disk & Book Series - Adventure Tsukuuru II.hdi
LOGiN Disk & Book Series - D.C. Connection | LOGiN Disk & Book Series - D.C. Connection.hdi
LOGiN Disk & Book Series - Hajimete no Daisenryaku | LOGiN Disk & Book Series - Hajimete no Daisenryaku.hdi
LOGiN Disk & Book Series - Kohakuiro no Yuigon | LOGiN Disk & Book Series - Kohakuiro no Yuigon.hdi
LOGiN Disk & Book Series - Multi-game Scripter | LOGiN Disk & Book Series - Multi-game Scripter.hdi
LOGiN Disk & Book Series - Ongaku Tsukuuru - LOGiN-ban Musium | LOGiN Disk & Book Series - Ongaku Tsukuuru - LOGiN-ban Musium.hdi
LOGiN Disk & Book Series - Pata Pata Anime Tsukuuru | LOGiN Disk & Book Series - Pata Pata Anime Tsukuuru.hdi
LOGiN Disk & Book Series - Polygon Modeling Tsukuuru | LOGiN Disk & Book Series - Polygon Modeling Tsukuuru.hdi
LOGiN Disk & Book Series - RPG Tsukuuru Dandan Dungeon | LOGiN Disk & Book Series - RPG Tsukuuru Dandan Dungeon.hdi
LOGiN Disk & Book Series - Shooting Tsukuuru 98 - Bakasuka Wars Hard Disk Taiou Ban | LOGiN Disk & Book Series - Shooting Tsukuuru 98 - Bakasuka Wars Hard Disk Taiou Ban.hdi
LOGiN Disk & Book Series - SimAnt Book | LOGiN Disk & Book Series - SimAnt Book.hdi
LOGiN Sofcom (Zeigis Senki Part 2 Kouhen) | LOGiN Sofcom (Zeigis Senki Part 2 Kouhen).hdi
Loop - Izanai no Kaikiten | Loop - Izanai no Kaikiten.hdi
Lord of Panzers | Lord of Panzers.hdi
Love Love Paradise | Love Love Paradise.hdi
Love Phantom | Love Phantom.hdi
Lua | Lua.hdi
Lunatic Dawn | Lunatic Dawn.hdi
Lunatic Dawn II | Lunatic Dawn II.hdi
M Hard | M Hard.hdi
Ma Doll | Ma Doll.hdi
Madou Gakuin R | Madou Gakuin R.hdi
Madou Monogatari A.R.S | Madou Monogatari A.R.S.hdi
Magic Master - Monster Maker 2 | Magic Master - Monster Maker 2.hdi
Magical Block Carat | Magical Block Carat.hdi
Magical Board (with palette fix) | Magical Board (with palette fix).hdi
Magical Jam | Magical Jam.hdi
Magical Panic | Magical Panic.hdi
Mah Saikou Jan | Mah Saikou Jan.hdi
Maha Barata | Maha Barata.hdi
Mahjong Bishoujoden Lipple | Mahjong Bishoujoden Lipple.hdi
Mahjong Elegance | Mahjong Elegance.hdi
Mahjong Fantasia (Mahjong Gensoukyoku) | Mahjong Fantasia (Mahjong Gensoukyoku).hdi
Mahjong Fantasia (Mahjong Gensoukyoku) II | Mahjong Fantasia (Mahjong Gensoukyoku) II.hdi
Mahjong Fantasia the 3rd Stage (Mahjong Gensoukyoku III) | Mahjong Fantasia the 3rd Stage (Mahjong Gensoukyoku III).hdi
Mahjong Goku Tenjiku | Mahjong Goku Tenjiku.hdi
Mahjong Hou Tei Rao Yui | Mahjong Hou Tei Rao Yui.hdi
Mahjong Mu | Mahjong Mu.hdi
Mahjong Plus | Mahjong Plus.hdi
Mahjong Princess Go! Go! - Chiruru the Mahjong Princess | Mahjong Princess Go! Go! - Chiruru the Mahjong Princess.hdi
Mahjong Sangokushi Engi | Mahjong Sangokushi Engi.hdi
Mahjong Sports Line | Mahjong Sports Line.hdi
Mahjong Triple Wars Gaiden | Mahjong Triple Wars Gaiden.hdi
Mahou no Princess Minky Momo - Fantastic World | Mahou no Princess Minky Momo - Fantastic World.hdi
Mahou no Tenshi Creamy Mami - Futari no Rondo | Mahou no Tenshi Creamy Mami - Futari no Rondo.hdi
Mahou no Tenshi Creamy Mami - Futatsu no Sekai no Monogatari | Mahou no Tenshi Creamy Mami - Futatsu no Sekai no Monogatari.hdi
Mahou Shoujo B-ko | Mahou Shoujo B-ko.hdi
Mahou Shoujo Fancy Coco | Mahou Shoujo Fancy Coco.hdi
Mai | Mai.hdi
Majogari no Yoru ni | Majogari no Yoru ni.hdi
Majokko Paradise | Majokko Paradise.hdi
Makyouden | Makyouden.hdi
Manami - Ai to Koukan no Hibi | Manami - Ai to Koukan no Hibi.hdi
Manami no Dokomade Ikuno 2 - Return of The Kuro Pack | Manami no Dokomade Ikuno 2 - Return of The Kuro Pack.hdi
Mandarake Ichizoku | Mandarake Ichizoku.hdi
Mankai Denshoku II | Mankai Denshoku II.hdi
Mankai Denshoku III | Mankai Denshoku III.hdi
Marble Cooking | Marble Cooking.hdi
Marble Madness | Marble Madness.hdi
Marginal Points | Marginal Points.hdi
Marginal Storys | Marginal Storys.hdi
Marine Buster | Marine Buster.hdi
Marine Philt | Marine Philt.hdi
Marine Rouge | Marine Rouge.hdi
Marines - Gairomu no Fuuin | Marines - Gairomu no Fuuin.hdi
Marion | Marion.hdi
Marionette Mind | Marionette Mind.hdi
Marple Magic | Marple Magic.hdi
Martial Age | Martial Age.hdi
Maryuu Gakuen - Kegasareta Nikutai | Maryuu Gakuen - Kegasareta Nikutai.hdi
Maryuu Gakuen - Nerawareta Shitai | Maryuu Gakuen - Nerawareta Shitai.hdi
Mashou no Kao | Mashou no Kao.hdi
Master of Monsters Final - Rings of Twilight | Master of Monsters Final - Rings of Twilight.hdi
Masters - Harukanaru Augusta 2 (New 3D Golf Simulation Ver. 2.5) | Masters - Harukanaru Augusta 2 (New 3D Golf Simulation Ver. 2.5).hdi
Maten Gakuen - Jigoku no Love Love Daisakusen | Maten Gakuen - Jigoku no Love Love Daisakusen.hdi
Mayumi | Mayumi.hdi
Mega lo Mania | Mega lo Mania.hdi
Megaton Arms - Koutetsu no Butoukai | Megaton Arms - Koutetsu no Butoukai.hdi
Meikyuu Gakuensai - Kyuukousha no Nazo | Meikyuu Gakuensai - Kyuukousha no Nazo.hdi
Meisou Toshi | Meisou Toshi.hdi
Meltylancer - The Melting Pot Police | Meltylancer - The Melting Pot Police.hdi
Memories - Shiroi Yozora ni Mau Tenshi | Memories - Shiroi Yozora ni Mau Tenshi.hdi
Memories Refrain - Omoide wa Itsumademo | Memories Refrain - Omoide wa Itsumademo....hdi
Mer Mer - Melty Marchen | Mer Mer - Melty Marchen.hdi
Mercurius Pretty | Mercurius Pretty.hdi
Merry Go Round | Merry Go Round.hdi
Messenger from Dark Night (patched) | Messenger from Dark Night (patched).hdi
Mesuneko Hishoshitsu | Mesuneko Hishoshitsu.hdi
Metajo - Furitsu Metatopology Daigaku Fuzoku Joshikoukou SP | Metajo - Furitsu Metatopology Daigaku Fuzoku Joshikoukou SP.hdi
Metal Eye | Metal Eye.hdi
Metal Eye 2 | Metal Eye 2.hdi
Metal Force (Speak Board) | Metal Force (Speak Board).hdi
Metal Mover Jastrike | Metal Mover Jastrike.hdi
Metamoru Meena | Metamoru Meena.hdi
Mezase! Top Player - Tennis Tennis 2 | Mezase! Top Player - Tennis Tennis 2 (HD Boot disk).hdm | Mezase! Top Player - Tennis Tennis 2.hdi
Michiyo Dreamy | Michiyo Dreamy.hdi
Microsoft Flight Simulator Version 4.0 (with Japan Scenery) | Microsoft Flight Simulator Version 4.0 (with Japan Scenery).hdi
Microsoft Flight Simulator Version 5.0a (with Microsoft Japan) | Microsoft Flight Simulator Version 5.0a (with Microsoft Japan).hdi
Microsoft Space Simulator - 42-oku Kounen no Fantasy | Microsoft Space Simulator - 42-oku Kounen no Fantasy.hdi
Microsoft Windows 1.03 | Microsoft Windows 1.03.hdi
Microsoft Windows 2.11 | Microsoft Windows 2.11.hdi
Microsoft Windows 3.1 (NEC OEM edition with extensions) | Microsoft Windows 3.1 (NEC OEM edition with extensions).hdi
Might and Magic III | Might and Magic III.hdi
Might and Magic V - Darkside of Xeen (256-color version) | Might and Magic V - Darkside of Xeen (256-color version).hdi
Migrain | Migrain.hdi
Miho | Miho.hdi
Million Fever | Million Fever.hdi
Mime (Special Version) | Mime (Special Version).hdi
Minami no Teiou | Minami no Teiou (HD Boot disk).hdm | Minami no Teiou.hdi
Mink no Omochabako Vol. 1 - Two Shot Diary 2 Special Disk | Mink no Omochabako Vol. 1 - Two Shot Diary 2 Special Disk.hdi
Mink no Omochabako Vol. 2 - Pero Pero Candy Special Disk | Mink no Omochabako Vol. 2 - Pero Pero Candy Special Disk.hdi
Mirage | Mirage.hdi
Mirage 2 | Mirage 2.hdi
Mirror | Mirror.hdi
Mischif | Mischif.hdi
Mission | Mission.hdi
Misty Flash | Misty Flash.hdi
Miwaku no Chousho | Miwaku no Chousho.hdi
Mobile Suit Gundam - A Year of War | Mobile Suit Gundam - A Year of War.hdi
Mobile Suit Gundam - MS Field 2 '93 | Mobile Suit Gundam - MS Field 2 '93.hdi
Mobile Suit Gundam - Multiple Operation | Mobile Suit Gundam - Multiple Operation.hdi
Mobile Suit Gundam 0083 - Stardust Operation | Mobile Suit Gundam 0083 - Stardust Operation.hdi
Mobius Roid | Mobius Roid.hdi
Moeru Asoko no Paipai Yuugi | Moeru Asoko no Paipai Yuugi.hdi
Mokkoriman RPG | Mokkoriman RPG.hdi
Momoiro Mahjong | Momoiro Mahjong.hdi
Momoko-chan for Me | Momoko-chan for Me.hdi
Monster Maker | Monster Maker.hdi
Monzetsu Fighter | Monzetsu Fighter.hdi
Moon Gate | Moon Gate.hdi
Moonlight Chan Rin Shan | Moonlight Chan Rin Shan.hdi
Moonlight Energy | Moonlight Energy.hdi
Moonlight Energy 2 | Moonlight Energy 2.hdi
Moratorium | Moratorium.hdi
More and More | More and More.hdi
Morita Shougi 4 | Morita Shougi 4.hdi
Morita Shougi 5 | Morita Shougi 5.hdi
Mouryou Senki Madara - Daikongourin Hen | Mouryou Senki Madara - Daikongourin Hen (HD Boot disk).hdm | Mouryou Senki Madara - Daikongourin Hen.hdi
Mr. Pro Yakyuu Perfect | Mr. Pro Yakyuu Perfect.hdi
MS-DOS 3.30C (with extensions) | MS-DOS 3.30C (with extensions).hdi
MS-DOS 3.30D | MS-DOS 3.30D.hdi
MS-DOS 5.00A (with upgrade) | MS-DOS 5.00A (with upgrade).hdi
MS-DOS 5.00A-H | MS-DOS 5.00A-H.hdi
MS-DOS 6.20 (with extensions and update) | MS-DOS 6.20 (with extensions and update).hdi
Mucchar-Soft (Ooinaru Isan II - The Hells Castle) | Mucchar-Soft (Ooinaru Isan II - The Hells Castle).hdi
Mug-R | Mug-R.hdi
Mugen Yasoukyoku | Mugen Yasoukyoku.hdi
Mujintou Monogatari 2 | Mujintou Monogatari 2 (HD Boot disk).hdm | Mujintou Monogatari 2.hdi
Mujintou Monogatari 3 - A.D. 1999 Tokyo | Mujintou Monogatari 3 - A.D. 1999 Tokyo.hdi
Muppet Box | Muppet Box.hdi
Musabori | Musabori.hdi
My Home Dream | My Home Dream.hdi
Myuu | Myuu.hdi
Namikaze Project (Nuri Nuri Meru-chan) | Namikaze Project (Nuri Nuri Meru-chan).hdi
Nampurrow (Sent Magical Girl Milfy Mayu) | Nampurrow (Sent Magical Girl Milfy Mayu).hdi
Nanaeiyuu Monogatari | Nanaeiyuu Monogatari.hdi
Nanaeiyuu Monogatari II | Nanaeiyuu Monogatari II.hdi
Nanba Kousuke Ikasete Nanbo! | Nanba Kousuke Ikasete Nanbo!.hdi
Naomi - Bishoujo-tachi no Yakata | Naomi - Bishoujo-tachi no Yakata.hdi
Naru Mahjong | Naru Mahjong.hdi
Neji Shiki | Neji Shiki.hdi
Neko Mahjong | Neko Mahjong.hdi
Neko Mamma EX | Neko Mamma EX.hdi
Nekomimi Soft (Neogal Fight) | Nekomimi Soft (Neogal Fight).hdi
NenGollo Software (Ponjalla no Houkago) | NenGollo Software (Ponjalla no Houkago).hdi
Never Land | Never Land.hdi
New 3D Golf Simulation | New 3D Golf Simulation.hdi
New York Spirits (Fervent Nereid Remix) | New York Spirits (Fervent Nereid Remix).hdi
Night Shifter | Night Shifter.hdi
Night Slave | Night Slave.hdi
Night Walker - Mayonaka no Tantei | Night Walker - Mayonaka no Tantei.hdi
Nijiiro Denshoku Musume | Nijiiro Denshoku Musume.hdi
Nike | Nike.hdi
Ningen Konchuu - Nozoki | Ningen Konchuu - Nozoki.hdi
Ningyo - Tsutako | Ningyo - Tsutako.hdi
Ningyou Tsukai 2 | Ningyou Tsukai 2.hdi
Nobunaga no Yabou - Haouden | Nobunaga no Yabou - Haouden (HD Boot disk).hdm | Nobunaga no Yabou - Haouden.hdi
Nobunaga no Yabou - Tenshouki (with Powerup Kit) | Nobunaga no Yabou - Tenshouki (with Powerup Kit) (HD Boot disk).hdm | Nobunaga no Yabou - Tenshouki (with Powerup Kit).hdi
Noltia | Noltia.hdi
Nonomura Byouin no Hitobito | Nonomura Byouin no Hitobito.hdi
Nooch - Abakareta Inbou | Nooch - Abakareta Inbou.hdi
Nooch 2 - Revenge of Remy | Nooch 2 - Revenge of Remy.hdi
Nooch 3 - Saigo no Seisen | Nooch 3 - Saigo no Seisen.hdi
Nouryokusha | Nouryokusha.hdi
Noushuku Angel 120% (U-Jin Presents) | Noushuku Angel 120% (U-Jin Presents).hdi
Nova | Nova.hdi
Nozokiya Kagyou | Nozokiya Kagyou.hdi
Nut Berry | Nut Berry.hdi
Oerstedia | Oerstedia.hdi
Ojousama Club (HD conversion) | Ojousama Club (HD conversion).hdi
OL Sousamou | OL Sousamou.hdi
Olivia's Mystery | Olivia's Mystery.hdi
Omega | Omega.hdi
oneoneman (Raid Wind Plus) | oneoneman (Raid Wind Plus).hdi
Onion Soft (The Tower of Zarbartz Special Edition '95) | Onion Soft (The Tower of Zarbartz Special Edition '95).hdi
Onnanoko no Shikumi | Onnanoko no Shikumi.hdi
Ooedo Renaissance | Ooedo Renaissance.hdi
Oozumou Kao Basho | Oozumou Kao Basho.hdi
Orange Diana (Magical Quiz Vol. 1) | Orange Diana (Magical Quiz Vol. 1).hdi
Overture (Himitsu Chouhoubuin 00 Nanako-chan Collection) | Overture (Himitsu Chouhoubuin 00 Nanako-chan Collection).hdi
P88SR - PC-8801mkIISR emulator for PC98 | P88SR - PC-8801mkIISR emulator for PC98.hdi
Pac-Man | Pac-Man.hdi
Pachinko Tenshi | Pachinko Tenshi.hdi
Pachislot Hishouden Same | Pachislot Hishouden Same.hdi
Paipai Ojanko | Paipai Ojanko.hdi
Panic Dolls | Panic Dolls.hdi
Panorama Club | Panorama Club.hdi
Panzer Division (Kikou Shidan) II | Panzer Division (Kikou Shidan) II.hdi
Paparazzo | Paparazzo.hdi
Paradise Arena (Gokuraku Arena) | Paradise Arena (Gokuraku Arena).hdi
Paradise Call | Paradise Call.hdi
Pasocomic Purple Cat Vol. 2 - Hospital Tokushuu | Pasocomic Purple Cat Vol. 2 - Hospital Tokushuu.hdi
Pasocomic Purple Cat Vol. 3 - Onna Kyoushi Tokushuu | Pasocomic Purple Cat Vol. 3 - Onna Kyoushi Tokushuu.hdi
Pasoket (Totsugeki Bakkon High School) | Pasoket (Totsugeki Bakkon High School).hdi
Pastel-Line (Heart Ease) | Pastel-Line (Heart Ease).hdi
Perfect Blue | Perfect Blue.hdi
Pero Pero Candy - You no Shou | Pero Pero Candy - You no Shou.hdi
Persona - Ingyaku no Kamen | Persona - Ingyaku no Kamen.hdi
Petinger | Petinger.hdi
Phantasie IV | Phantasie IV.hdi
Pia Carrot e Youkoso!! | Pia Carrot e Youkoso!!.hdi
Pick Up Mahjong Master | Pick Up Mahjong Master.hdi
Pick Up Yadokari Eisei Housoukyoku 1 | Pick Up Yadokari Eisei Housoukyoku 1.hdi
Pick Up Yadokari Eisei Housoukyoku 2 | Pick Up Yadokari Eisei Housoukyoku 2.hdi
Pick Up Yadokari Eisei Housoukyoku 3 | Pick Up Yadokari Eisei Housoukyoku 3.hdi
Pick Up Yadokari Eisei Housoukyoku 4 | Pick Up Yadokari Eisei Housoukyoku 4.hdi
Pick Up Yadokari Eisei Housoukyoku 5 | Pick Up Yadokari Eisei Housoukyoku 5.hdi
Pink Sox Presents | Pink Sox Presents.hdi
Pink Tiger | Pink Tiger.hdi
Pixy Garden - Yousei Densetsu | Pixy Garden - Yousei Densetsu.hdi
Planet's Edge | Planet's Edge.hdi
Planets of Dragon | Planets of Dragon.hdi
Pleria - The Royal Emblem | Pleria - The Royal Emblem.hdi
Pocky | Pocky.hdi
Pocky 2 | Pocky 2.hdi
Poison Needle | Poison Needle.hdi
Police Quest II | Police Quest II.hdi
Ponkan | Ponkan.hdi
Ponyon | Ponyon.hdi
Popful Mail | Popful Mail.hdi
Possessioner | Possessioner.hdi
Power Derby | Power Derby.hdi
Power Dolls | Power Dolls (HD Boot disk).hdm | Power Dolls.hdi
Power Dolls 2 | Power Dolls 2 (HD Boot disk).hdm | Power Dolls 2.hdi
Power Dolls 2 Dash | Power Dolls 2 Dash.hdi
Power Dolls S-Premium Disk | Power Dolls S-Premium Disk.hdi
Power Slave | Power Slave.hdi
Powered Gals | Powered Gals.hdi
Powermonger | Powermonger.hdi
Premium | Premium.hdi
Presence | Presence.hdi
Present 2 | Present 2.hdi
Present Duo | Present Duo.hdi
Pretty Mahjong Soldier Mu (Bishoujo Janshi Mu) | Pretty Mahjong Soldier Mu (Bishoujo Janshi Mu).hdi
Pretty Sentai Kyarurun | Pretty Sentai Kyarurun.hdi
Primal Space | Primal Space.hdi
Princess Danger | Princess Danger.hdi
Princess Maker | Princess Maker.hdi
Princess Maker 2 | Princess Maker 2.hdi
Princess Quest - Mahjong Sword | Princess Quest - Mahjong Sword.hdi
Private Slave | Private Slave.hdi
Pro Student G | Pro Student G (uncensored).hdi
Progenitor | Progenitor (HD Boot disk).hdm | Progenitor.hdi
Proper (Walpurgis Night 3) | Proper (Walpurgis Night 3).hdi
Puru Puru Paradise | Puru Puru Paradise.hdi
Quarterstaff - The Tomb of Setmoth | Quarterstaff - The Tomb of Setmoth.hdi
Queen's Library | Queen's Library.hdi
Quest for Glory | Quest for Glory.hdi
Quintia Road II | Quintia Road II.hdi
Quiz Banchou - 3ta-kun (Santa-kun) 2 | Quiz Banchou - 3ta-kun (Santa-kun) 2.hdi
Quiz Chiryaku no Hasha - Sangokushi Kitan | Quiz Chiryaku no Hasha - Sangokushi Kitan.hdi
Quiz de Grand Prix | Quiz de Grand Prix.hdi
Quiz de Let's Go!! | Quiz de Let's Go!!.hdi
Quiz Eto Cetera | Quiz Eto Cetera.hdi
Quiz Tonosama no Yabou - Zenkokuban | Quiz Tonosama no Yabou - Zenkokuban.hdi
Rabyni | Rabyni.hdi
RAC Rally | RAC Rally (HD Boot disk).hdm | RAC Rally.hdi
Ragnarokkr | Ragnarokkr.hdi
Raika - Kasenkyuu | Raika - Kasenkyuu.hdi
Railroad Tycoon Deluxe | Railroad Tycoon Deluxe.hdi
Rakudai Tenshi Coron | Rakudai Tenshi Coron.hdi
Rakuichi no Matsuri | Rakuichi no Matsuri.hdi
Rall III - Kakusei-hen | Rall III - Kakusei-hen.hdi
Rance 4.1 | Rance 4.1.hdi
Rance 4.1+4.2 Hint Disk (Hashiri Onna II - Running Girls) | Rance 4.1+4.2 Hint Disk (Hashiri Onna II - Running Girls).hdi
Rance 4.2 | Rance 4.2.hdi
Rance II | Rance II.hdi
Rance III | Rance III (uncensored).hdi | Rance III.hdi
Rance IV | Rance IV.hdi
Rankou Nyotaitsuri - Mokkoriman no Nani de Nushitsuri | Rankou Nyotaitsuri - Mokkoriman no Nani de Nushitsuri.hdi
Ranma 1-2 - Hiryuu Densetsu | Ranma 1-2 - Hiryuu Densetsu.hdi
Ranma 1-2 Ougi Jaanken | Ranma 1-2 Ougi Jaanken.hdi
Rarue | Rarue.hdi
Re-No - Stayin' Alive | Re-No - Stayin' Alive.hdi
Recomposer98 Ver. 3.0 (with Update Kit 04) | Recomposer98 Ver. 3.0 (with Update Kit 04).hdi
Red | Red.hdi
Red Cobra | Red Cobra.hdi
Red Storm Rising | Red Storm Rising.hdi
Reijou Monogatari | Reijou Monogatari.hdi
Reijuu - Twin Road | Reijuu - Twin Road.hdi
Reira | Reira.hdi
Rekiai | Rekiai.hdi
Restricted Area - Tachiiri Kinshi Ryouiki | Restricted Area - Tachiiri Kinshi Ryouiki.hdi
Resurrect | Resurrect.hdi
Reverse | Reverse.hdi
Reverser - Hyouketsu Toshi Tokyo | Reverser - Hyouketsu Toshi Tokyo.hdi
Revery - Izanai no Masuishou | Revery - Izanai no Masuishou.hdi
Revival Xanadu Easy Mode (FD version) | Revival Xanadu Easy Mode (FD version).hdi
Rhyme Star | Rhyme Star.hdi
Ribbon | Ribbon.hdi
Rinkan Gakkou | Rinkan Gakkou.hdi
Ripple Cafe | Ripple Cafe.hdi
Romance wa Tsurugi no Kagayaki - The Last Crusader | Romance wa Tsurugi no Kagayaki - The Last Crusader.hdi
Rome Wasn't Built in a Day (Rome wa 1-Nichi ni Shite Narazu) | Rome Wasn't Built in a Day (Rome wa 1-Nichi ni Shite Narazu).hdi
Rommel - Battles for North Africa | Rommel - Battles for North Africa.hdi
Rondo | Rondo.hdi
Rose Blood - Chi no Kawaki | Rose Blood - Chi no Kawaki.hdi
Rosei-Soft (Super Ahodayon II X) | Rosei-Soft (Super Ahodayon II X).hdi
Round Warrior | Round Warrior.hdi
Russian Mahjong Khorosho! | Russian Mahjong Khorosho!.hdi
Rusty | Rusty.hdi
Ryuoh Sangokushi (with Power Box) | Ryuoh Sangokushi (with Power Box).hdi
Ryuuki Denshou - Dragoon | Ryuuki Denshou - Dragoon.hdi
S-Express | S-Express.hdi
S.A. 3 | S.A. 3.hdi
Saint Diary | Saint Diary.hdi
Sakura no Kisetsu | Sakura no Kisetsu.hdi
Sakura no Mori | Sakura no Mori.hdi
Sakusaku Daigoutou Returns | Sakusaku Daigoutou Returns.hdi
Sala | Sala.hdi
Sangoku Bushou Souha - Sangokushi Fighter | Sangoku Bushou Souha - Sangokushi Fighter.hdi
Sangokushi Eiketsuden | Sangokushi Eiketsuden (HD Boot disk).hdm | Sangokushi Eiketsuden.hdi
Sangokushi Fukkokuban [HD] [uncracked] | Sangokushi Fukkokuban (HD Boot disk) [uncracked].hdm | Sangokushi Fukkokuban [uncracked].hdi
Sangokushi IV | Sangokushi IV (HD Boot disk).hdm | Sangokushi IV.hdi
Sanshimai | Sanshimai.hdi
Saori - Bishoujo-tachi no Yakata | Saori - Bishoujo-tachi no Yakata.hdi
Sargon V | Sargon V.hdi
Satyr | Satyr.hdi
Sayaka - Gibo | Sayaka - Gibo.hdi
School Days | School Days.hdi
School Festival - Cosmos-sai Kitan | School Festival - Cosmos-sai Kitan.hdi
School Girls | School Girls.hdi
Secret Eyes | Secret Eyes.hdi
Seek | Seek.hdi
Seisenshi Mokkoriman | Seisenshi Mokkoriman.hdi
Seishoujo Sentai Lakers | Seishoujo Sentai Lakers.hdi
Seishoujo Sentai Lakers II | Seishoujo Sentai Lakers II.hdi
Seishoujo Sentai Lakers III | Seishoujo Sentai Lakers III.hdi
Seiyoku Gakuen Seraphita | Seiyoku Gakuen Seraphita.hdi
Sekai Seifuku - Colonial Conquest | Sekai Seifuku - Colonial Conquest.hdi
Semattemitai | Semattemitai.hdi
Sengoku Tsuwamono Emaki Ranze | Sengoku Tsuwamono Emaki Ranze.hdi
Senran | Senran.hdi
Setsujuu - Yuganda Kioku | Setsujuu - Yuganda Kioku.hdi
Sex | Sex.hdi
Shaburi Hime - In no Shou | Shaburi Hime - In no Shou.hdi
ShadowCaster | ShadowCaster (HD Boot disk).hdm | ShadowCaster.hdi
Shake! Shake! 2 | Shake! Shake! 2.hdi
Shangrlia | Shangrlia.hdi
Shangrlia 2 | Shangrlia 2.hdi
Shinc | Shinc.hdi
Shinjuku Monogatari | Shinjuku Monogatari.hdi
Shinou Densetsu Crystania | Shinou Densetsu Crystania.hdi
Shinou Densetsu Crystania DX | Shinou Densetsu Crystania DX.hdi
Shinsetsu Chuushingura | Shinsetsu Chuushingura.hdi
Shinsetsu Kamiya Ukyo 2 | Shinsetsu Kamiya Ukyo 2.hdi
Shinsetsu Oedo Tantei Kamiya Ukyo | Shinsetsu Oedo Tantei Kamiya Ukyo.hdi
Shinwaden - Hatou no Shou | Shinwaden - Hatou no Shou.hdi
Shiritsu Tantei Max 2 - Master of Elemental | Shiritsu Tantei Max 2 - Master of Elemental.hdi
Shiroganeya (Bonnou CG Shuu - Shirubeiru Vol. 2) | Shiroganeya (Bonnou CG Shuu - Shirubeiru Vol. 2).hdi
Shisetsu Sangokushi | Shisetsu Sangokushi.hdi
Shisetsu Sengoku Jidai | Shisetsu Sengoku Jidai.hdi
Shizuku | Shizuku.hdi
Shougi Bijin Taikyoku | Shougi Bijin Taikyoku.hdi
Shougi Saikyou | Shougi Saikyou.hdi
Shougi Seiten | Shougi Seiten.hdi
Shougi Seiten II | Shougi Seiten II.hdi
Shouryuu Sangokushi | Shouryuu Sangokushi.hdi
Showdown | Showdown.hdi
Shuukan From H | Shuukan From H.hdi
Sichuan | Sichuan.hdi
Sid Meier's Civilization | Sid Meier's Civilization.hdi
SimAnt [HD] [req Data disk] | SimAnt.hdi
SimCity 2000 | SimCity 2000 (HD Boot disk).hdm | SimCity 2000.hdi
SimCity 2000 DX | SimCity 2000 DX (HD Boot disk).hdm | SimCity 2000 DX.hdi
SimEarth | SimEarth.hdi
SimFarm | SimFarm.hdi
Skirmish | Skirmish.hdi
Slayers | Slayers.hdi
Slip Stream '93 | Slip Stream '93.hdi
Slip Stream '93 Rev-LIMIT | Slip Stream '93 Rev-LIMIT.hdi
Snow Memory | Snow Memory.hdi
Soft Circle Courreges (Yume de Yaretara... 1995 version) | Soft Circle Courreges (Yume de Yaretara... 1995 version).hdi
Soft Studio RantaNoid (Un Chat Andalou Vol. 2) | Soft Studio RantaNoid (Un Chat Andalou Vol. 2).hdi
Soko-ban Select 30 | Soko-ban Select 30.hdi
Solid Lancer | Solid Lancer.hdi
Sonic Linker | Sonic Linker.hdi
Sorcer Kingdom | Sorcer Kingdom.hdi
Sotsugyou - Graduation | Sotsugyou - Graduation.hdi
Sotsugyou II - Neo Generation | Sotsugyou II - Neo Generation.hdi
Sotsugyou Ryokou | Sotsugyou Ryokou.hdi
Sotsugyou Shashin 2 - Raspberry Dream | Sotsugyou Shashin 2 - Raspberry Dream.hdi
Sotsugyou Shashin Episode 1 - Naked Color | Sotsugyou Shashin Episode 1 - Naked Color.hdi
Soukou Kihei Votoms - The Real Battle | Soukou Kihei Votoms - The Real Battle.hdi
Space Hulk | Space Hulk.hdi
Space Invaders | Space Invaders.hdi
Space Quest IV | Space Quest IV.hdi
Spin Ball | Spin Ball.hdi
Splush Wave (Tequira Sunrise) | Splush Wave (Tequira Sunrise).hdi
St. Jeremiah Gakuen | St. Jeremiah Gakuen.hdi
Star Cruiser II | Star Cruiser II (HD Boot disk).hdm | Star Cruiser II.hdi
Star Platinum | Star Platinum.hdi
Star Striders | Star Striders.hdi
Star Trap | Star Trap.hdi
Star Wars - Attack on the Deathstar | Star Wars - Attack on the Deathstar.hdi
Starfire | Starfire.hdi
Steam Heart's | Steam Heart's.hdi
Strange World | Strange World.hdi
Strategic Air Force (Senryaku Kuugun) | Strategic Air Force (Senryaku Kuugun).hdi
Stratego | Stratego.hdi
Street Mahjong 2 | Street Mahjong 2.hdi
Strike Commander | Strike Commander (HD Boot disk).hdm | Strike Commander.hdi
Strip Roulette | Strip Roulette.hdi
Strip Roulette - Kageki Hen | Strip Roulette - Kageki Hen.hdi
Strip Roulette - Lolita Hen | Strip Roulette - Lolita Hen.hdi
Stronghold - Koutei no Yousai | Stronghold - Koutei no Yousai.hdi
Strush | Strush.hdi
Studio Genmaicha (Steel Gun Nyan) | Studio Genmaicha (Steel Gun Nyan).hdi
Studio Mandrake (GRID2.1) | Studio Mandrake (GRID2.1) [installed].hdi
Studio Pickles (Zansou) | Studio Pickles (Zansou).hdi
Studio Ray (Dungeon Walkers) | Studio Ray (Dungeon Walkers).hdi
Suki! | Suki!.hdi
Super D.P.S (Dream Program System) | Super D.P.S (Dream Program System).hdi
Super Dog World | Super Dog World (HD Boot disk).hdm | Super Dog World.hdi
Super Erect Taisen S-EX | Super Erect Taisen S-EX.hdi
Super Real Mahjong PII & PIII | Super Real Mahjong PII & PIII.hdi
Super Real Mahjong PIV | Super Real Mahjong PIV.hdi
Super Ultra Mucchin Puripuri Cyborg Marilyn DX | Super Ultra Mucchin Puripuri Cyborg Marilyn DX.hdi
Super Yakyuudou 2 | Super Yakyuudou 2 (HD Boot disk).hdm | Super Yakyuudou 2.hdi
Super Yakyuudou 2 1995 Ban | Super Yakyuudou 2 1995 Ban (HD Boot disk).hdm | Super Yakyuudou 2 1995 Ban.hdi
Susume! Choujou Genshou Kenkyuubu!! | Susume! Choujou Genshou Kenkyuubu!!.hdi
Sweet Angel | Sweet Angel.hdi
Sweet Days | Sweet Days.hdi
Sweet Emotion | Sweet Emotion.hdi
Sword Dancer 2 - Goddess of the Evil Blade | Sword Dancer 2 - Goddess of the Evil Blade.hdi
Sword Dancer Zoukangou | Sword Dancer Zoukangou.hdi
Sword Dancer Zoukangou '93 | Sword Dancer Zoukangou '93.hdi
Sword World PC | Sword World PC.hdi
Syndicate (256-color version) | Syndicate (256-color version) (HD Boot disk).hdm | Syndicate (256-color version).hdi
T&H Projects (P-Fight!) | T&H Projects (P-Fight!).hdi
Tabohaze Kobo (Weapons Free) | Tabohaze Kobo (Weapons Free).hdi
Taboo | Taboo.hdi
Tactical Tank Corps | Tactical Tank Corps.hdi
Tactical Tank Corps DX | Tactical Tank Corps DX.hdi
Taiheiyou no Arashi 2 (with Scenario Pack) | Taiheiyou no Arashi 2 (with Scenario Pack).hdi
Taiheiyou Senki | Taiheiyou Senki.hdi
Taikou Risshiden II | Taikou Risshiden II (HD Boot disk).hdm | Taikou Risshiden II.hdi
Takamizawa Kyosuke - Nekketsu!! Kyouiku Kenshuu | Takamizawa Kyosuke - Nekketsu!! Kyouiku Kenshuu.hdi
Tamashii no Mon - Dante Shinkyoku yori | Tamashii no Mon - Dante Shinkyoku yori (HD Boot disk).hdm | Tamashii no Mon - Dante Shinkyoku yori.hdi
Tania | Tania.hdi
Tanjou - Debut | Tanjou - Debut.hdi
Taxi Genmutan - Strange World Act 2 | Taxi Genmutan - Strange World Act 2.hdi
Team Z&3N (C.G. Gallery 9 Enterprise) | Team Z&3N (C.G. Gallery 9 Enterprise).hdi
Team Zero (Sentimental Graphics Vol. 1) | Team Zero (Sentimental Graphics Vol. 1).hdi
Teen | Teen.hdi
Teito Metsuzoku Shidan | Teito Metsuzoku Shidan.hdi
Teitoku no Ketsudan II (with Powerup Kit) | Teitoku no Ketsudan II (with Powerup Kit) (HD Boot disk).hdm | Teitoku no Ketsudan II (with Powerup Kit).hdi
Teitoku no Ketsudan III (with Powerup Kit) | Teitoku no Ketsudan III (with Powerup Kit) (HD Boot disk).hdm | Teitoku no Ketsudan III (with Powerup Kit).hdi
Tekkou Kikan Atragon | Tekkou Kikan Atragon.hdi
Tenbu - Mankan Zenseki | Tenbu - Mankan Zenseki.hdi
Tenchi Muyo! Ryo Oh Ki | Tenchi Muyo! Ryo Oh Ki.hdi
Tenka Gomen | Tenka Gomen.hdi
Tenkousei | Tenkousei.hdi
Tensen Nyan Nyan | Tensen Nyan Nyan.hdi
Tenshi-tachi no Gogo Collection | Tenshi-tachi no Gogo Collection.hdi
Tenshi-tachi no Gogo Collection 2 | Tenshi-tachi no Gogo Collection 2.hdi
Tenshi-tachi no Gogo Tenkousei | Tenshi-tachi no Gogo Tenkousei.hdi
Tenshi-tachi no Gogo VI - My Fair Teacher | Tenshi-tachi no Gogo VI - My Fair Teacher.hdi
Tenshi-tachi no Hohoemi | Tenshi-tachi no Hohoemi.hdi
Tenshin Ranma | Tenshin Ranma.hdi
Tessera (IV) | Tessera (IV).hdi
Tetris | Tetris.hdi
Tetris 2 + Bombliss | Tetris 2 + Bombliss.hdi
The 7 Colors | The 7 Colors.hdi
The Atlas HD - Hard Disk Only | The Atlas HD - Hard Disk Only.hdi
The Atlas II | The Atlas II.hdi
The Block Buster | The Block Buster.hdi
The Golem Master | The Golem Master.hdi
The Grail Hunter | The Grail Hunter.hdi
The Incredible Machine | The Incredible Machine.hdi
The Internet Contest Park (Yakata - Red Letter Day) | The Internet Contest Park (Yakata - Red Letter Day).hdi
The Knights 2 - Little Light from Nowhere | The Knights 2 - Little Light from Nowhere.hdi
The Legend of Heroes (Eiyuu Densetsu) III - Shiroki Majo | The Legend of Heroes (Eiyuu Densetsu) III - Shiroki Majo.hdi
The Magic Candle | The Magic Candle.hdi
The Manhole | The Manhole (HD Boot disk).hdm | The Manhole.hdi
The Masquerade | The Masquerade.hdi
The Queen of Duellist Gaiden | The Queen of Duellist Gaiden.hdi
The Queen of Duellist Gaiden Alpha | The Queen of Duellist Gaiden Alpha.hdi
The Return of Ishtar | The Return of Ishtar.hdi
The Silent Service (Chinmoku no Kantai) | The Silent Service (Chinmoku no Kantai).hdi
The Story of King Aress (Aress Ou no Monogatari) | The Story of King Aress (Aress Ou no Monogatari).hdi
The Summoning - Asu e no Shoukan | The Summoning - Asu e no Shoukan.hdi
The Super Dimension Fortress Macross - Love Stories | The Super Dimension Fortress Macross - Love Stories.hdi
The Super Dimension Fortress Macross - Skull Leader | The Super Dimension Fortress Macross - Skull Leader.hdi
Themm - Harukanaru Meikyuu | Themm - Harukanaru Meikyuu.hdi
Thexder | Thexder.hdi
Time Slip Toujankyou - Joshikousei no Nazo | Time Slip Toujankyou - Joshikousei no Nazo.hdi
Time Stripper Mako-chan | Time Stripper Mako-chan.hdi
Tinkle - Zenimusume | Tinkle - Zenimusume.hdi
Tinyan (Tinyan Software Collection) | Tinyan (Tinyan Software Collection).hdi
TKO Soft (Yuugekitai Kakutou Hen (English)) | TKO Soft (Yuugekitai Kakutou Hen (English)).hdi
To Five | To Five.hdi
Toge | Toge.hdi
Tokimeki Bishoujo | Tokimeki Bishoujo.hdi
Tokimeki Sports Gal III | Tokimeki Sports Gal III.hdi
Tokio - Tokyo-to Dai-24-ku | Tokio - Tokyo-to Dai-24-ku.hdi
Tokyo Fuuzoku Kikou | Tokyo Fuuzoku Kikou.hdi
Tokyo Twilight Busters | Tokyo Twilight Busters.hdi
Tonight | Tonight.hdi
Top Management II | Top Management II (HD Boot disk).hdm | Top Management II.hdi
Toraware no Tenshi | Toraware no Tenshi.hdi
Toshabutsu Software (Mad Quiz & Crazy Response Kyu) | Toshabutsu Software (Mad Quiz & Crazy Response Kyu).hdi
Totsugeki! Bakkon Street | Totsugeki! Bakkon Street.hdi
Totsugeki! Mix | Totsugeki! Mix.hdi
Touhai Yuugi - Jankihi Densetsu | Touhai Yuugi - Jankihi Densetsu.hdi
Toukyou Club (Rinshitsu no Chikubi) | Toukyou Club (Rinshitsu no Chikubi).hdi
Toumei Ningen | Toumei Ningen.hdi
Toushin Toshi | Toushin Toshi.hdi
Toushin Toshi II (v1.04) | Toushin Toshi II (v1.04).hdi
Travel Junction | Travel Junction.hdi
Trial of Fours | Trial of Fours.hdi
Trigger | Trigger.hdi
Trigger 2 | Trigger 2.hdi
Trouble Cash | Trouble Cash.hdi
Trouble Outsiders | Trouble Outsiders.hdi
True Heart | True Heart.hdi
True Love - Junai Monogatari | True Love - Junai Monogatari.hdi
Trush Box | Trush Box.hdi
Tsuioku | Tsuioku.hdi
Tsumobaka Nisshi | Tsumobaka Nisshi.hdi
Tsumokki | Tsumokki.hdi
Tunnels & Trolls | Tunnels & Trolls.hdi
Turn Over | Turn Over.hdi
Twilight | Twilight.hdi
Twilight Hotel | Twilight Hotel.hdi
Two Shot Diary | Two Shot Diary.hdi
Two Shot Diary 2 Memory 1 of 4 | Two Shot Diary 2 Memory 1 of 4.hdi
Two Shot Diary 2 Memory 2 of 4 | Two Shot Diary 2 Memory 2 of 4.hdi
Two Shot Diary 2 Memory 3 of 4 | Two Shot Diary 2 Memory 3 of 4.hdi
Two Shot Diary 2 Memory 4 of 4 | Two Shot Diary 2 Memory 4 of 4.hdi
U-Jin Special Collection (Kounai Shasei re-release) | U-Jin Special Collection (Kounai Shasei re-release) (Vol. 1).hdi | U-Jin Special Collection (Kounai Shasei re-release) (Vol. 2).hdi | U-Jin Special Collection (Kounai Shasei re-release) (Vol. 3).hdi
Uchuu Kaitou Funny Bee | Uchuu Kaitou Funny Bee.hdi
Uchuu no Kishi Tekkaman Blade - Orbital Ring Dakkai Sakusen | Uchuu no Kishi Tekkaman Blade - Orbital Ring Dakkai Sakusen.hdi
Ugetsu Kitan | Ugetsu Kitan.hdi
Uki Uki Island | Uki Uki Island.hdi
Ultima Underworld | Ultima Underworld (HD Boot disk).hdm | Ultima Underworld.hdi
Ultima Underworld II | Ultima Underworld II (HD Boot disk).hdm | Ultima Underworld II.hdi
Ultima VIII - Pagan | Ultima VIII - Pagan.hdi
Ultimate Blade | Ultimate Blade.hdi
Ultra Sakusen - Katokutai Shutsugeki Seyo! | Ultra Sakusen - Katokutai Shutsugeki Seyo!.hdi
Umanari 1 Furlong Theater | Umanari 1 Furlong Theater.hdi
Umanari 1 Furlong Theater 2 | Umanari 1 Furlong Theater 2.hdi
Unknown (Who is the Strongest!! Turbo) | Unknown (Who is the Strongest!! Turbo).hdi
Ura Mansion Hakkin | Ura Mansion Hakkin.hdi
Urban Soldier | Urban Soldier.hdi
Usagi na Panic 2 | Usagi na Panic 2.hdi
Ushinawareta Rakuen | Ushinawareta Rakuen.hdi
V Zone | V Zone.hdi
V.G. - Variable Geo | V.G. - Variable Geo.hdi
V.G. II - The Bout of Cabalistic Goddess | V.G. II - The Bout of Cabalistic Goddess.hdi
V.R. Date - May Club | V.R. Date - May Club.hdi
Vain Dream II | Vain Dream II.hdi
Valentine Kiss - Birth Days 2 | Valentine Kiss - Birth Days 2.hdi
Valkyrie - The Power Beauties | Valkyrie - The Power Beauties.hdi
Vampire High School | Vampire High School (HD Boot disk).hdm | Vampire High School.hdi
Vanishing Point - Tenshi no Kieta Machi | Vanishing Point - Tenshi no Kieta Machi.hdi
Veil of Darkness - Norowareta Yogen | Veil of Darkness - Norowareta Yogen.hdi
Venus | Venus.hdi
Vette! San Francisco City Race | Vette! San Francisco City Race.hdi
Vidro Drops | Vidro Drops.hdi
Viper BTR - Mahou no Tobakushi Totocal Chiyomi | Viper BTR - Mahou no Tobakushi Totocal Chiyomi.hdi
Viper GTS - Akuma wa Futatabi | Viper GTS - Akuma wa Futatabi.hdi
Viper GTS RS | Viper GTS RS.hdi
Viper V10 | Viper V10.hdi
Viper V10 RS | Viper V10 RS.hdi
Viper V12 | Viper V12.hdi
Viper V16 | Viper V16.hdi
Viper V6 (with Turbo Kit) | Viper V6 (with Turbo Kit).hdi
Viper V8 | Viper V8.hdi
Viper V8 RS | Viper V8 RS.hdi
Virgin Dream | Virgin Dream.hdi
Virgin^2 | Virgin^2.hdi
Virtuacall | Virtuacall.hdi
Visitte | Visitte.hdi
Waku Waku Mahjong Panic! - Shikigami Denshou | Waku Waku Mahjong Panic! - Shikigami Denshou.hdi
Waku Waku Mahjong Panic! 2 - Kokushi Musou | Waku Waku Mahjong Panic! 2 - Kokushi Musou.hdi
Wakusei Omega no Q Ouji | Wakusei Omega no Q Ouji.hdi
War in the South Pacific (Gekitotsu! Nichibei Kidoubutai) | War in the South Pacific (Gekitotsu! Nichibei Kidoubutai).hdi
Waver - The Seeker 2 | Waver - The Seeker 2.hdi
Wedding Errantry - Gyakutama Ou | Wedding Errantry - Gyakutama Ou.hdi
Wedding Peach | Wedding Peach.hdi
Welcome to Cinemahouse (Youkoso Cinemahouse e) | Welcome to Cinemahouse (Youkoso Cinemahouse e).hdi
What is Fantasy | What is Fantasy.hdi
Will no Dengon | Will no Dengon.hdi
Wing Commander - Armada | Wing Commander - Armada.hdi
Winning Horse | Winning Horse.hdi
Winning Post (with Powerup Kit) | Winning Post (with Powerup Kit) (Base game boot disk).hdm | Winning Post (with Powerup Kit) (Powerup kit boot disk).hdm | Winning Post (with Powerup Kit).hdi
Winning Post 2 Plus (with Powerup Kit) | Winning Post 2 Plus (with Powerup Kit) (HD Boot disk).hdm | Winning Post 2 Plus (with Powerup Kit).hdi
Wizard V5 | Wizard V5.hdi
Wizardry VI | Wizardry VI (HD Boot disk).hdm | Wizardry VI.hdi
Wizardry VII | Wizardry VII (HD Boot disk).hdm | Wizardry VII.hdi
Wolfenstein 3D | Wolfenstein 3D.hdi
Wolfish Gallop - Solomon no Isan | Wolfish Gallop - Solomon no Isan (HD Boot disk).hdm | Wolfish Gallop - Solomon no Isan.hdi
Wonpara Wars | Wonpara Wars.hdi
Wonpara Wars II | Wonpara Wars II.hdi
Words Worth | Words Worth.hdi
Workaholic (Mikeneko Yu-chan) | Workaholic (Mikeneko Yu-chan).hdi
Worlds of Ultima - The Savage Empire | Worlds of Ultima - The Savage Empire.hdi
Wrestle Angels 2 - Top Eventer | Wrestle Angels 2 - Top Eventer.hdi
Wrestle Angels 3 | Wrestle Angels 3.hdi
Wrestle Angels Special | Wrestle Angels Special.hdi
Wrestle Angels V1 | Wrestle Angels V1.hdi
Wrestle Angels V2 | Wrestle Angels V2.hdi
Wrestle Angels V3 | Wrestle Angels V3.hdi
X | X.hdi
X-Girl | X-Girl.hdi
XEDISS | XEDISS.hdi
Yadokari Eisei Housoukyoku BS-896 | Yadokari Eisei Housoukyoku BS-896.hdi
Yami no Ryousen | Yami no Ryousen.hdi
Yanyan no Gekitou Dousoukai - The Queen of Tenshindo '95 | Yanyan no Gekitou Dousoukai - The Queen of Tenshindo '95.hdi
Yanyan no Quiz Itchomae | Yanyan no Quiz Itchomae.hdi
YES! - Youthful Eager Stories | YES! - Youthful Eager Stories.hdi
YES! HG | YES! HG.hdi
Yoshinaga Sayuri ga Yattekuru Yaa! Yaa! Yaa! - A Hard Day's Night | Yoshinaga Sayuri ga Yattekuru Yaa! Yaa! Yaa! - A Hard Day's Night.hdi
Yougekitai - Jashin Koumaroku | Yougekitai - Jashin Koumaroku.hdi
Yougen Doumu | Yougen Doumu.hdi
Youjuu Club Custom | Youjuu Club Custom.hdi
Youjuu Kyoushitsu | Youjuu Kyoushitsu.hdi
Youjuu Senki - A.D. 2048 | Youjuu Senki - A.D. 2048.hdi
Youjuu Senki 2 - Reimei no Senshi-tachi | Youjuu Senki 2 - Reimei no Senshi-tachi.hdi
Yubiwa Monogatari (Lord of the Rings) Dai-1-kan - Tabi no Nakama | Yubiwa Monogatari (Lord of the Rings) Dai-1-kan - Tabi no Nakama.hdi
Yubiwa Monogatari (Lord of the Rings) Dai-2-kan - Futatsu no Tou | Yubiwa Monogatari (Lord of the Rings) Dai-2-kan - Futatsu no Tou.hdi
Yume Utsutsu - Dreamy | Yume Utsutsu - Dreamy.hdi
Yumeji - Asakusa Kitan | Yumeji - Asakusa Kitan.hdi
Yumemizaka | Yumemizaka.hdi
Yuu Disk Vol. 4 - Crystal Rinal Otanoshimi Disk | Yuu Disk Vol. 4 - Crystal Rinal Otanoshimi Disk.hdi
Yuu Disk Vol. 6 - Heart de Ron!! Midnight-hen | Yuu Disk Vol. 6 - Heart de Ron!! Midnight-hen.hdi
Yuu Disk Vol. 7 - Moonlight Chan Rin Shan Bangaihen | Yuu Disk Vol. 7 - Moonlight Chan Rin Shan Bangaihen.hdi
Yuu Disk Vol. 8 - Cybernoid Alpha Yuu Disk-ban | Yuu Disk Vol. 8 - Cybernoid Alpha Yuu Disk-ban.hdi
Yuu Disk Vol. 9 - Arquelphos Gekitou-hen | Yuu Disk Vol. 9 - Arquelphos Gekitou-hen.hdi
Yuugiri | Yuugiri.hdi
Yuurou - Transient Sands | Yuurou - Transient Sands.hdi
Yuuwaku | Yuuwaku.hdi
Yuuwaku no Toiki | Yuuwaku no Toiki.hdi
Zavas II - The Prophecy of Mehitae | Zavas II - The Prophecy of Mehitae.hdi
Zero Senki | Zero Senki.hdi
Zest to fantasy | Zest to fantasy.hdi
Zhuang Yang Jia Yao | Zhuang Yang Jia Yao.hdi
Zoku Youjuu Senki - Sajin no Mokushiroku | Zoku Youjuu Senki - Sajin no Mokushiroku.hdi
